6 6 6 6 6 6 6 6 6 6 6 6 6 6 6 6 6 6 6 6 6 6 6 6 6 6 6 6 6 6 6 6 6 6 6 6 6 6 6 6 6 6 6 6 6 6 6 6 6 6
6 12 12 12 12 12 12 12 12 12 12 12 12 12 12 12 12 12 12 12 12 12 12 12 12 12 12 12 12 12 12 12 12 12 12 12 12 12 12 12 12 12 12 12 12 12 12 12 12 6
6 12 12 12 12 12 12 12 12 12 12 12 12 12 12 12 12 12 12 12 12 12 12 12 12 12 12 12 12 12 12 12 12 12 12 12 12 12 12 12 12 12 12 12 12 12 12 12 12 6
6 12 12 12 12 12 12 12 12 12 12 12 12 12 12 12 12 12 12 12 12 12 12 12 12 12 12 12 12 12 12 12 12 12 12 12 12 12 12 12 12 12 12 12 12 12 12 12 12 6
6 12 12 12 12 12 12 12 12 12 12 12 12 12 12 12 12 12 12 12 12 12 12 12 12 12 12 12 12 12 12 12 12 12 12 12 12 12 12 12 12 12 12 12 12 12 12 12 12 6
6 12 12 12 12 12 12 12 12 12 12 12 12 12 12 12 12 12 12 12 12 12 12 12 12 12 12 12 12 12 10 10 10 10 10 10 12 12 12 12 12 12 12 12 12 12 12 12 12 6
6 12 12 12 12 12 12 12 12 12 12 12 12 12 12 12 12 12 12 12 12 12 12 12 12 12 12 12 12 12 10 10 10 10 10 10 12 12 12 12 12 12 12 6 12 12 12 12 12 6
6 12 12 12 12 12 12 12 12 12 12 12 12 12 12 12 12 12 12 12 9 9 9 12 12 12 9 9 9 12 10 10 10 10 10 10 12 12 12 12 12 12 12 6 12 12 12 12 12 6
6 12 12 12 12 12 12 12 12 12 12 12 12 12 12 12 12 12 12 12 9 9 9 12 12 12 9 9 9 12 10 10 10 10 10 10 12 12 12 12 12 12 12 6 12 12 12 12 12 6
6 12 12 12 12 12 12 12 12 12 12 12 12 12 12 12 12 12 12 12 9 9 9 12 12 12 9 9 9 12 10 10 10 10 10 10 12 12 12 12 12 12 12 6 12 12 12 12 12 6
6 12 12 12 12 12 12 12 12 12 12 12 6 12 12 12 12 12 12 7 9 9 9 7 12 7 9 9 9 7 10 10 10 10 10 10 12 12 12 12 12 12 12 6 12 12 12 12 12 6
6 12 12 12 12 12 12 12 12 12 12 12 6 12 12 12 12 12 12 7 9 9 9 7 12 7 9 9 9 7 10 10 10 10 10 10 12 12 12 12 12 12 12 6 12 12 12 12 12 6
6 12 12 12 12 12 12 12 12 12 12 12 6 12 12 12 12 12 12 7 9 9 9 7 12 7 9 9 9 7 10 10 10 10 10 10 12 12 12 12 12 12 12 6 12 12 12 12 12 6
6 12 12 12 12 12 12 12 12 12 12 12 6 12 12 12 12 12 12 7 9 9 9 7 12 7 9 9 9 7 12 12 12 12 12 12 12 12 12 12 12 12 12 6 12 12 12 12 12 6
6 12 12 12 12 12 12 12 12 12 12 12 6 12 12 12 12 12 12 7 9 9 9 7 7 7 9 9 9 7 7 7 12 12 12 12 12 12 12 6 6 6 6 6 12 12 12 12 12 6
6 12 12 12 12 12 12 12 12 12 12 12 6 12 12 12 12 12 12 7 8 8 8 8 8 8 8 8 8 8 8 7 12 12 12 12 12 12 12 6 12 12 12 12 12 12 12 12 12 6
6 12 12 12 12 12 12 12 12 12 12 12 6 12 12 12 12 12 7 7 8 8 8 8 8 8 8 8 8 8 8 7 7 12 12 12 12 12 12 6 12 12 12 12 12 12 12 12 12 6
6 12 12 12 12 12 12 12 12 12 12 12 6 12 12 12 12 12 7 8 8 8 8 8 8 8 8 8 8 8 8 8 7 12 12 12 12 12 12 6 12 12 12 12 12 12 12 12 12 6
6 12 12 12 12 12 12 12 12 12 12 12 6 12 12 12 12 7 7 8 8 8 8 8 8 8 8 8 8 8 8 8 7 7 12 12 12 12 12 6 12 12 12 12 12 12 12 12 12 6
6 12 12 12 12 12 12 12 12 12 12 12 6 12 12 12 12 7 8 8 8 8 8 8 8 8 8 8 8 8 8 8 8 7 12 12 12 12 12 6 12 12 12 12 12 12 12 12 12 6
6 12 12 12 12 12 12 12 12 12 12 12 6 12 12 12 12 7 8 8 8 8 8 8 8 8 8 8 8 8 8 8 8 7 6 6 6 6 6 6 12 12 12 12 12 12 12 12 12 6
6 12 12 12 12 6 6 6 6 6 6 6 6 6 6 6 6 7 8 8 8 8 8 8 8 8 8 8 8 8 8 8 8 7 12 12 12 12 12 12 12 12 12 12 12 12 12 12 12 6
6 12 12 12 12 12 12 12 12 12 12 12 6 12 12 12 12 7 7 8 8 8 8 8 8 8 8 8 8 8 8 8 7 7 12 12 12 12 12 12 12 12 12 12 12 12 12 12 12 6
6 12 12 12 12 12 12 12 12 12 12 12 6 12 12 12 12 12 7 8 8 8 8 8 8 8 8 8 8 8 8 8 7 12 12 12 12 12 12 12 12 12 12 12 12 12 12 12 12 6
6 12 12 12 12 12 12 12 12 12 12 12 6 12 12 12 12 12 7 7 8 8 8 8 8 8 8 8 8 8 8 8 7 12 12 12 12 12 12 12 12 12 12 12 12 12 12 12 12 6
6 12 12 12 12 12 12 12 12 12 12 12 6 12 12 12 12 12 12 7 8 8 8 8 8 8 8 8 8 8 8 7 7 12 12 12 12 12 12 12 12 12 12 12 12 12 12 12 12 6
6 12 12 12 12 12 12 12 12 12 12 12 6 12 12 12 12 12 12 7 7 7 7 8 8 8 8 8 8 8 8 7 12 12 12 12 12 12 12 12 12 12 12 12 12 12 12 12 12 6
6 12 12 12 12 12 12 12 12 12 12 12 6 12 12 12 12 12 12 12 12 12 7 8 8 8 8 8 8 8 8 7 12 12 12 12 12 12 12 12 12 12 12 12 12 12 12 12 12 6
6 12 12 12 12 12 12 12 12 12 12 12 6 12 12 12 12 12 12 12 12 12 7 7 7 7 8 8 8 8 7 7 12 12 12 12 12 12 12 12 12 12 12 12 12 12 12 12 12 6
6 12 12 12 12 12 12 12 12 12 12 12 6 12 12 12 12 12 12 12 12 12 12 12 12 7 7 7 7 7 7 12 12 12 12 12 12 12 12 12 12 12 12 12 12 12 12 12 12 6
6 12 12 12 12 12 12 12 12 12 12 12 6 12 12 12 12 12 12 12 12 12 12 12 12 12 12 12 12 12 12 12 12 12 12 12 12 12 12 12 12 12 12 12 12 12 12 12 12 6
6 12 12 12 12 10 10 10 12 12 12 12 6 12 12 12 12 12 12 12 12 12 12 12 12 12 12 12 12 12 12 12 12 12 12 12 12 12 12 12 12 12 12 12 12 12 12 12 12 6
6 12 12 12 12 10 10 10 12 12 12 12 6 12 12 12 12 12 12 12 12 12 12 12 12 12 12 12 12 12 12 12 12 12 12 12 12 12 12 12 12 12 12 12 12 12 12 12 12 6
6 12 12 12 12 10 10 10 12 12 12 12 6 12 12 12 12 12 12 12 12 12 12 12 12 12 12 12 12 12 12 12 12 12 12 12 12 12 12 12 12 12 12 12 12 12 12 12 12 6
6 12 12 12 12 10 10 10 12 12 12 12 6 12 12 12 12 12 12 12 12 12 12 12 12 12 12 12 12 12 12 12 12 12 12 12 12 12 12 12 12 12 12 12 12 12 12 12 12 6
6 12 12 12 12 10 10 10 12 12 12 12 6 6 6 6 6 6 6 6 6 12 12 12 12 12 12 12 12 12 12 12 12 12 12 12 12 12 12 12 12 12 12 12 12 12 12 12 12 6
6 12 12 12 12 10 10 10 12 12 12 12 12 12 12 12 12 12 12 12 6 12 12 12 12 12 12 12 12 12 12 12 12 12 12 12 12 12 12 12 12 12 12 12 12 12 12 12 12 6
6 12 12 12 12 12 12 12 12 12 12 12 12 12 12 12 12 12 12 12 6 12 12 12 12 12 12 12 12 12 12 12 12 12 12 11 11 11 11 11 11 11 11 12 12 12 12 12 12 6
6 12 12 12 12 12 12 12 12 12 12 12 12 12 12 12 12 12 12 12 12 12 12 12 12 12 12 12 12 12 12 12 12 12 12 11 11 11 11 11 11 11 11 12 12 12 12 12 12 6
6 12 12 12 12 12 12 12 12 12 12 12 12 12 12 12 12 12 12 12 12 12 12 12 12 12 12 12 12 12 12 12 12 12 12 11 11 11 11 11 11 11 11 12 12 12 12 12 12 6
6 12 12 12 12 12 12 12 12 12 12 12 12 12 12 12 12 12 12 12 6 12 12 12 12 12 12 12 12 12 12 12 12 12 12 11 11 11 11 11 11 11 11 12 12 12 12 12 12 6
6 12 12 12 12 12 12 12 12 12 12 12 12 12 12 12 12 12 12 12 6 12 12 12 12 12 12 12 12 12 12 12 12 12 12 11 11 11 11 11 11 11 11 12 12 12 12 12 12 6
6 6 6 6 6 6 6 6 6 6 6 6 6 6 6 6 6 6 6 6 6 12 12 12 12 12 12 12 12 12 12 12 12 12 12 11 11 11 11 11 11 11 11 12 12 12 12 12 12 6
6 12 12 12 12 12 12 12 12 12 12 12 12 12 12 12 12 12 12 12 12 12 12 12 12 12 12 12 12 12 12 12 12 12 12 11 11 11 11 11 11 11 11 12 12 12 12 12 12 6
6 12 12 12 12 12 12 12 12 12 12 12 12 12 12 12 12 12 12 12 12 12 12 12 12 12 12 12 12 12 12 12 12 12 12 12 12 12 12 12 12 12 12 12 12 12 12 12 12 6
6 12 12 12 12 12 12 12 12 12 12 12 12 12 12 12 12 12 12 12 12 12 12 12 12 12 12 12 12 12 12 12 12 12 12 12 12 12 12 12 12 12 12 12 12 12 12 12 12 6
6 12 12 12 12 12 12 12 12 12 12 12 12 12 12 12 12 12 12 12 12 12 12 12 12 12 12 12 12 12 12 12 12 12 12 12 12 12 12 12 12 12 12 12 12 12 12 12 12 6
6 12 12 12 12 12 12 12 12 12 12 12 12 12 12 12 12 12 12 12 12 12 12 12 12 12 12 12 12 12 12 12 12 12 12 12 12 12 12 12 12 12 12 12 12 12 12 12 12 6
6 12 12 12 12 12 12 12 12 12 12 12 12 12 12 12 12 12 12 12 12 12 12 12 12 12 12 12 12 12 12 12 12 12 12 12 12 12 12 12 12 12 12 12 12 12 12 12 12 6
6 6 6 6 6 6 6 6 6 6 6 6 6 6 6 6 6 6 6 6 6 6 6 6 6 6 6 6 6 6 6 6 6 6 6 6 6 6 6 6 6 6 6 6 6 6 6 6 6 6
